0

10

10
3
3
3
3
3
3
3
3
3
3

20

0
0
0
0
0
0
0
0
0
0
0
0
0
0
0
0
0
0
0
0

2 0 0 2 0 0 2 0 0 0
0 0 0 0 0 0 0 0 0 0
0 0 0 0 0 0 0 0 0 0
0 0 0 0 0 0 0 0 0 0
0 0 0 0 0 0 0 0 0 0
0 0 0 0 0 0 0 0 0 0
0 0 0 0 0 0 0 0 0 0
0 0 0 0 0 0 0 0 0 0
0 0 0 0 0 0 0 0 0 0
2 0 0 2 0 0 2 0 0 0

6 0 0 6 0 0 6 0 0 0
0 0 0 0 0 0 0 0 0 0
0 0 0 0 0 0 0 0 0 0
0 0 0 0 0 0 0 0 0 0
0 0 0 0 0 0 0 0 0 0
0 0 0 0 0 0 0 0 0 0
0 0 0 0 0 0 0 0 0 0
0 0 0 0 0 0 0 0 0 0
0 0 0 0 0 0 0 0 0 0
6 0 0 6 0 0 6 0 0 0

4 0 0 4 0 0 4 0 0 0
0 0 0 0 0 0 0 0 0 0
0 0 0 0 0 0 0 0 0 0
0 0 0 0 0 0 0 0 0 0
0 0 0 0 0 0 0 0 0 0
0 0 0 0 0 0 0 0 0 0
0 0 0 0 0 0 0 0 0 0
0 0 0 0 0 0 0 0 0 0
0 0 0 0 0 0 0 0 0 0
4 0 0 4 0 0 4 0 0 0

6 0 0 6 0 0 6 0 0 0
0 0 0 0 0 0 0 0 0 0
0 0 0 0 0 0 0 0 0 0
0 0 0 0 0 0 0 0 0 0
0 0 0 0 0 0 0 0 0 0
0 0 0 0 0 0 0 0 0 0
0 0 0 0 0 0 0 0 0 0
0 0 0 0 0 0 0 0 0 0
0 0 0 0 0 0 0 0 0 0
6 0 0 6 0 0 6 0 0 0

6 0 0 6 0 0 6 0 0 0
0 0 0 0 0 0 0 0 0 0
0 0 0 0 0 0 0 0 0 0
0 0 0 0 0 0 0 0 0 0
0 0 0 0 0 0 0 0 0 0
0 0 0 0 0 0 0 0 0 0
0 0 0 0 0 0 0 0 0 0
0 0 0 0 0 0 0 0 0 0
0 0 0 0 0 0 0 0 0 0
6 0 0 6 0 0 6 0 0 0

6 0 0 6 0 0 6 0 0 0
0 0 0 0 0 0 0 0 0 0
0 0 0 0 0 0 0 0 0 0
0 0 0 0 0 0 0 0 0 0
0 0 0 0 0 0 0 0 0 0
0 0 0 0 0 0 0 0 0 0
0 0 0 0 0 0 0 0 0 0
0 0 0 0 0 0 0 0 0 0
0 0 0 0 0 0 0 0 0 0
6 0 0 6 0 0 6 0 0 0

6 0 0 6 0 0 6 0 0 0
0 0 0 0 0 0 0 0 0 0
0 0 0 0 0 0 0 0 0 0
0 0 0 0 0 0 0 0 0 0
0 0 0 0 0 0 0 0 0 0
0 0 0 0 0 0 0 0 0 0
0 0 0 0 0 0 0 0 0 0
0 0 0 0 0 0 0 0 0 0
0 0 0 0 0 0 0 0 0 0
6 0 0 6 0 0 6 0 0 0

1 0 0 1 0 0 1 0 0 0
11 0 0 11 0 0 11 0 0 0
0 0 0 14 13 0 0 0 0 0
0 0 0 0 13 12 0 0 0 0
0 0 0 0 0 13 13 0 0 0
0 0 0 0 0 0 0 11 0 0
0 0 0 0 0 0 0 0 13 0
0 0 0 0 0 0 0 0 0 12
11 0 0 11 0 0 11 0 0 0
1 0 0 1 0 0 1 0 0 0

2 0 0 2 0 0 2 0 0 0
0 0 0 0 0 0 0 0 0 0
0 0 0 0 0 0 0 0 0 0
0 0 0 0 0 0 0 0 0 0
0 0 0 0 0 0 0 0 0 0
0 0 0 0 0 0 0 0 0 0
0 0 0 0 0 0 0 0 0 0
0 0 0 0 0 0 0 0 0 0
0 0 0 0 0 0 0 0 0 0
2 0 0 2 0 0 2 0 0 0

1 0 0 1 0 0 1 0 0 0
11 0 0 11 0 0 11 0 0 0
0 0 0 14 13 0 0 0 0 0
0 0 0 0 13 12 0 0 0 0
0 0 0 0 0 13 13 0 0 0
0 0 0 0 0 0 0 11 0 0
0 0 0 0 0 0 0 0 13 0
0 0 0 0 0 0 0 0 0 12
11 0 0 11 0 0 11 0 0 0
1 0 0 1 0 0 1 0 0 0

1 0 0 1 0 0 1 0 0 0
11 0 0 11 0 0 11 0 0 0
0 0 0 14 13 0 0 0 0 0
0 0 0 0 13 12 0 0 0 0
0 0 0 0 0 13 13 0 0 0
0 0 0 0 0 0 0 11 0 0
0 0 0 0 0 0 0 0 13 0
0 0 0 0 0 0 0 0 0 12
11 0 0 11 0 0 11 0 0 0
1 0 0 1 0 0 1 0 0 0

1 0 0 1 0 0 1 0 0 0
11 0 0 11 0 0 11 0 0 0
0 0 0 14 13 0 0 0 0 0
0 0 0 0 13 12 0 0 0 0
0 0 0 0 0 13 13 0 0 0
0 0 0 0 0 0 0 11 0 0
0 0 0 0 0 0 0 0 13 0
0 0 0 0 0 0 0 0 0 12
11 0 0 11 0 0 11 0 0 0
1 0 0 1 0 0 1 0 0 0

1 0 0 1 0 0 1 0 0 0
11 0 0 11 0 0 11 0 0 0
0 0 0 14 13 0 0 0 0 0
0 0 0 0 13 12 0 0 0 0
0 0 0 0 0 13 13 0 0 0
0 0 0 0 0 0 0 11 0 0
0 0 0 0 0 0 0 0 13 0
0 0 0 0 0 0 0 0 0 12
11 0 0 11 0 0 11 0 0 0
1 0 0 1 0 0 1 0 0 0

4 0 0 4 0 0 4 0 0 0
0 0 0 0 0 0 0 0 0 0
0 0 0 0 0 0 0 0 0 0
0 0 0 0 0 0 0 0 0 0
0 0 0 0 0 0 0 0 0 0
0 0 0 0 0 0 0 0 0 0
0 0 0 0 0 0 0 0 0 0
0 0 0 0 0 0 0 0 0 0
0 0 0 0 0 0 0 0 0 0
4 0 0 4 0 0 4 0 0 0

6 0 0 6 0 0 6 0 0 0
0 0 0 0 0 0 0 0 0 0
0 0 0 0 0 0 0 0 0 0
0 0 0 0 0 0 0 0 0 0
0 0 0 0 0 0 0 0 0 0
0 0 0 0 0 0 0 0 0 0
0 0 0 0 0 0 0 0 0 0
0 0 0 0 0 0 0 0 0 0
0 0 0 0 0 0 0 0 0 0
6 0 0 6 0 0 6 0 0 0

7 0 0 7 0 0 7 0 0 0
0 0 0 0 0 0 0 0 0 0
0 0 0 0 0 0 0 0 0 0
0 0 0 0 0 0 0 0 0 0
0 0 0 0 0 0 0 0 0 0
0 0 0 0 0 0 0 0 0 0
0 0 0 0 0 0 0 0 0 0
0 0 0 0 0 0 0 0 0 0
0 0 0 0 0 0 0 0 0 0
7 0 0 7 0 0 7 0 0 0

2 0 0 2 0 0 2 0 0 0
0 0 0 0 0 0 0 0 0 0
0 0 0 0 0 0 0 0 0 0
0 0 0 0 0 0 0 0 0 0
0 0 0 0 0 0 0 0 0 0
0 0 0 0 0 0 0 0 0 0
0 0 0 0 0 0 0 0 0 0
0 0 0 0 0 0 0 0 0 0
0 0 0 0 0 0 0 0 0 0
2 0 0 2 0 0 2 0 0 0

5 0 0 5 0 0 5 0 0 0
0 0 0 0 0 0 0 0 0 0
0 0 0 0 0 0 0 0 0 0
0 0 0 0 0 0 0 0 0 0
0 0 0 0 0 0 0 0 0 0
0 0 0 0 0 0 0 0 0 0
0 0 0 0 0 0 0 0 0 0
0 0 0 0 0 0 0 0 0 0
0 0 0 0 0 0 0 0 0 0
5 0 0 5 0 0 5 0 0 0

1 0 0 1 0 0 1 0 0 0
11 0 0 11 0 0 11 0 0 0
0 0 0 14 13 0 0 0 0 0
0 0 0 0 13 12 0 0 0 0
0 0 0 0 0 13 13 0 0 0
0 0 0 0 0 0 0 11 0 0
0 0 0 0 0 0 0 0 13 0
0 0 0 0 0 0 0 0 0 12
11 0 0 11 0 0 11 0 0 0
1 0 0 1 0 0 1 0 0 0

1 0 0 1 0 0 1 0 0 0
15 15 15 15 15 15 15 15 15 15
15 15 15 15 15 15 15 15 15 15
15 15 15 15 15 15 15 15 15 15
15 15 15 15 15 15 15 15 15 15
15 15 15 15 15 15 15 15 15 15
15 15 15 15 15 15 15 15 15 15
15 15 15 15 15 15 15 15 15 15
15 15 15 15 15 15 15 15 15 15
1 0 0 1 0 0 1 0 0 0

