0

5

4
0
0
0
0

19

0
0
0
0
0
0
0
0
0
0
0
0
0
0
0
0
0
0
0

3 2 3 2 3
0 0 0 0 0
0 0 0 0 0
2 3 2 3 2

3 2 3 2 3
0 0 0 0 0
0 0 0 0 0
2 3 2 3 2

3 2 3 2 3
0 0 0 0 0
0 1 0 0 0
2 3 2 3 2

3 2 3 2 3
0 1 0 0 0
0 0 0 0 0
2 3 2 3 2

3 2 3 2 3
0 0 0 0 0
3 3 3 3 3
2 3 2 3 2

3 2 3 2 3
0 3 0 0 0
1 3 1 1 1
2 3 2 3 2

4 2 3 2 4
0 1 0 0 0
0 1 0 0 0
4 2 3 2 4

3 3 3 3 3
0 0 0 1 0
0 0 0 1 0
3 3 3 3 3

3 2 3 2 3
0 0 0 0 0
0 0 0 0 0
2 3 2 3 2

3 2 3 2 3
0 1 0 0 0
0 0 0 0 0
2 3 2 3 2

3 2 3 2 3
0 0 0 0 0
3 3 3 3 3
2 3 2 3 2

3 2 3 2 3
0 3 0 0 0
1 3 1 1 1
2 3 2 3 2

2 3 2 3 2
0 0 0 1 1
1 1 0 0 0
2 3 2 3 2

2 3 2 3 2
1 1 1 1 1
0 1 0 0 0
3 2 3 2 3

2 2 2 2 2 
0 0 0 0 0 
0 0 0 0 0 
2 2 2 2 2 

2 2 2 2 2 
0 0 0 0 0 
0 0 0 0 0 
2 2 2 2 2 

2 2 2 2 2 
0 0 0 0 0 
0 0 0 0 0 
2 2 2 2 2 

2 2 2 2 2 
0 0 0 0 0 
0 0 0 0 0 
2 2 2 2 2 

2 2 2 2 2 
0 0 0 0 0 
0 0 0 0 0 
2 2 2 2 2 

