0

10

2
2
1

4

0 1 2 1 2 3 3 4 2 1
1 2 4 2 4 3 2 1 2 3

1 3 2 0 2 0 2 1 0 4
4 3 2 4 2 2 4 1 3 2

0 4 3 2 4 3 2 4 3 2
4 3 4 4 3 2 0 2 1 4

2 0 4 2 4 1 2 4 2 3
4 3 0 2 4 1 2 0 4 2