0

5

8
3
3
3
3
3
3
3
3

30

0
0
0
0
0
0
0
0
0
0
0
0
0
0
0
0
0
0
0
0
0
0
0
0
0
0
0
0
0
0

2 2 2 2 2 
0 0 0 0 0 
0 1 0 0 0 
2 2 2 2 2 
2 2 2 2 2 
0 0 0 0 0 
0 1 0 0 0 
2 2 2 2 2 

2 2 2 2 2 
0 0 0 0 0 
0 1 0 0 0 
2 2 2 2 2 
2 2 2 2 2 
0 0 0 0 0 
0 1 0 0 0 
2 2 2 2 2 

2 2 2 2 2 
0 0 0 0 0 
0 1 0 0 0 
2 2 2 2 2 
2 2 2 2 2 
0 0 0 0 0 
0 1 0 0 0 
2 2 2 2 2 

2 2 2 2 2 
0 0 0 0 0 
0 1 0 0 0 
2 2 2 2 2 
2 2 2 2 2 
0 0 0 0 0 
0 1 0 0 0 
2 2 2 2 2 

2 2 2 2 2 
0 0 0 0 0 
0 1 0 0 0 
2 2 2 2 2 
2 2 2 2 2 
0 0 0 0 0 
0 1 0 0 0 
2 2 2 2 2 

2 2 2 2 2 
0 0 0 0 0 
0 1 0 0 0 
2 2 2 2 2 
2 2 2 2 2 
0 0 0 0 0 
0 1 0 0 0 
2 2 2 2 2 

2 2 2 2 2 
0 0 0 0 0 
0 1 0 0 0 
2 2 2 2 2 
2 2 2 2 2 
0 0 0 0 0 
0 1 0 0 0 
2 2 2 2 2 

2 2 2 2 2 
0 0 0 0 0 
0 1 0 0 0 
2 2 2 2 2 
2 2 2 2 2 
0 0 0 0 0 
0 1 0 0 0 
2 2 2 2 2 

2 2 2 2 2 
0 0 0 0 0 
0 1 0 0 0 
2 2 2 2 2 
2 2 2 2 2 
0 0 0 0 0 
0 1 0 0 0 
2 2 2 2 2 

2 2 2 2 2 
0 0 0 0 0 
0 1 0 0 0 
2 2 2 2 2 
2 2 2 2 2 
0 0 0 0 0 
0 1 0 0 0 
2 2 2 2 2 

2 2 2 2 2 
0 0 0 0 0 
0 1 0 0 0 
2 2 2 2 2 
2 2 2 2 2 
0 0 0 0 0 
0 1 0 0 0 
2 2 2 2 2 

2 2 2 2 2 
0 0 0 0 0 
0 1 0 0 0 
2 2 2 2 2 
2 2 2 2 2 
0 0 0 0 0 
0 1 0 0 0 
2 2 2 2 2 

2 2 2 2 2 
0 0 0 0 0 
0 1 0 0 0 
2 2 2 2 2 
2 2 2 2 2 
0 0 0 0 0 
0 1 0 0 0 
2 2 2 2 2 

2 2 2 2 2 
0 0 0 0 0 
0 1 0 0 0 
2 2 2 2 2 
2 2 2 2 2 
0 0 0 0 0 
0 1 0 0 0 
2 2 2 2 2 

2 2 2 2 2 
0 0 0 0 0 
0 1 0 0 0 
2 2 2 2 2 
2 2 2 2 2 
0 0 0 0 0 
0 1 0 0 0 
2 2 2 2 2 

2 2 2 2 2 
0 0 0 0 0 
0 1 0 0 0 
2 2 2 2 2 
2 2 2 2 2 
0 0 0 0 0 
0 1 0 0 0 
2 2 2 2 2 

2 2 2 2 2 
0 0 0 0 0 
0 1 0 0 0 
2 2 2 2 2 
2 2 2 2 2 
0 0 0 0 0 
0 1 0 0 0 
2 2 2 2 2 

2 2 2 2 2 
0 0 0 0 0 
0 1 0 0 0 
2 2 2 2 2 
2 2 2 2 2 
0 0 0 0 0 
0 1 0 0 0 
2 2 2 2 2 

2 2 2 2 2 
0 0 0 0 0 
0 1 0 0 0 
2 2 2 2 2 
2 2 2 2 2 
0 0 0 0 0 
0 1 0 0 0 
2 2 2 2 2 

2 2 2 2 2 
0 0 0 0 0 
0 1 0 0 0 
2 2 2 2 2 
2 2 2 2 2 
0 0 0 0 0 
0 1 0 0 0 
2 2 2 2 2 

2 2 2 2 2 
0 0 0 0 0 
0 1 0 0 0 
2 2 2 2 2 
2 2 2 2 2 
0 0 0 0 0 
0 1 0 0 0 
2 2 2 2 2 

2 2 2 2 2 
0 0 0 0 0 
0 1 0 0 0 
2 2 2 2 2 
2 2 2 2 2 
0 0 0 0 0 
0 1 0 0 0 
2 2 2 2 2 

2 2 2 2 2 
0 0 0 0 0 
0 1 0 0 0 
2 2 2 2 2 
2 2 2 2 2 
0 0 0 0 0 
0 1 0 0 0 
2 2 2 2 2 

2 2 2 2 2 
0 0 0 0 0 
0 1 0 0 0 
2 2 2 2 2 
2 2 2 2 2 
0 0 0 0 0 
0 1 0 0 0 
2 2 2 2 2 

2 2 2 2 2 
0 0 0 0 0 
0 1 0 0 0 
2 2 2 2 2 
2 2 2 2 2 
0 0 0 0 0 
0 1 0 0 0 
2 2 2 2 2 

2 2 2 2 2 
0 0 0 0 0 
0 1 0 0 0 
2 2 2 2 2 
2 2 2 2 2 
0 0 0 0 0 
0 1 0 0 0 
2 2 2 2 2 

2 2 2 2 2 
0 0 0 0 0 
0 1 0 0 0 
2 2 2 2 2 
2 2 2 2 2 
0 0 0 0 0 
0 1 0 0 0 
2 2 2 2 2 

2 2 2 2 2 
0 0 0 0 0 
0 1 0 0 0 
2 2 2 2 2 
2 2 2 2 2 
0 0 0 0 0 
0 1 0 0 0 
2 2 2 2 2 

2 2 2 2 2 
0 0 0 0 0 
0 1 0 0 0 
2 2 2 2 2 
2 2 2 2 2 
0 0 0 0 0 
0 1 0 0 0 
2 2 2 2 2 

2 2 2 2 2 
0 0 0 0 0 
0 1 0 0 0 
2 2 2 2 2 
2 2 2 2 2 
0 0 0 0 0 
0 1 0 0 0 
2 2 2 2 2 

