0

5

4
5
3
3
5

16

0
1
2
3
4
5
6
7
8
9
10
11
12
13
14
15

2 2 2 2 2
0 0 0 0 0
1 1 1 1 1
2 2 2 2 2

2 2 2 2 2
0 0 0 0 0
1 1 1 1 1
2 2 2 2 2

2 2 2 2 2
0 0 0 0 0
1 1 1 1 1
2 2 2 2 2

2 2 2 2 2
0 0 0 0 0
1 1 1 1 1
2 2 2 2 2

2 2 2 2 2
0 0 0 0 0
1 1 1 1 1
2 2 2 2 2

2 2 2 2 2
0 0 0 1 1
1 1 0 0 0
2 2 2 2 2

2 2 2 2 2
1 1 1 1 1
0 0 0 0 0
2 2 2 2 2

2 2 2 2 2
1 1 1 1 1
0 0 0 0 0
2 2 2 2 2

2 2 2 2 2
1 1 1 1 1
0 0 0 0 0
2 2 2 2 2

2 2 2 2 2
1 1 1 1 1
0 0 0 0 0
2 2 2 2 2

2 2 2 2 2
1 1 1 1 1
0 0 0 0 0
2 2 2 2 2

2 2 2 2 2
1 1 0 0 0
0 0 0 1 1
2 2 2 2 2

2 2 2 2 2
0 0 0 0 0
1 1 1 1 1
2 2 2 2 2

2 2 2 2 2
0 0 0 0 0
1 1 1 1 1
2 2 2 2 2

2 2 2 2 2
0 0 0 0 0
1 1 1 1 1
2 2 2 2 2

2 2 2 2 2
0 0 0 0 0
1 1 1 1 1
2 2 2 2 2

