0

5

4
3
3
3
3

12

0
0
0
0
0
0
0
0
0
0
0
0

2 2 2 2 2 
0 0 0 0 0 
0 1 0 0 0 
2 2 2 2 2 

2 2 2 2 2 
0 0 0 0 0 
0 1 0 0 0 
2 2 2 2 2 

2 2 2 2 2 
0 0 0 0 0 
0 1 0 0 0 
2 2 2 2 2 

2 2 2 2 2 
0 0 0 0 0 
0 1 0 0 0 
2 2 2 2 2 

2 2 2 2 2 
0 0 0 0 0 
0 1 0 0 0 
2 2 2 2 2 

2 2 2 2 2 
0 0 0 0 0 
0 1 0 0 0 
2 2 2 2 2 

2 2 2 2 2 
0 0 0 0 0 
0 1 0 0 0 
2 2 2 2 2 

2 2 2 2 2 
0 0 0 0 0 
0 1 0 0 0 
2 2 2 2 2 

2 2 2 2 2 
0 0 0 0 0 
0 1 0 0 0 
2 2 2 2 2 

2 2 2 2 2 
0 0 0 0 0 
0 1 0 0 0 
2 2 2 2 2 

2 2 2 2 2 
0 0 0 0 0 
0 1 0 0 0 
2 2 2 2 2 

2 2 2 2 2 
0 0 0 0 0 
0 1 0 0 0 
2 2 2 2 2 

