10

3
4
4
4

42

0 0 0 0 0 0 0 0 0 0
1 2 1 2 1 2 1 2 1 2
1 0 0 0 1 0 0 0 1 0

1 1 1 1 1 1 1 1 1 1
1 2 3 4 1 2 3 4 1 2
0 0 1 0 0 0 1 0 0 0

0 0 0 0 0 0 0 0 0 0
1 2 1 2 1 2 1 2 1 2
1 0 0 0 1 0 0 0 1 0

0 0 0 0 0 0 0 0 0 0
1 2 1 2 1 2 1 2 1 2
1 0 0 0 1 0 0 0 1 0

0 0 0 0 0 0 0 0 0 0
1 2 1 2 1 2 1 2 1 2
1 0 0 0 1 0 0 0 1 0

1 1 1 1 1 1 1 1 1 1
1 2 3 4 1 2 3 4 1 2
0 0 1 0 0 0 1 0 0 0

1 1 1 1 1 1 1 1 1 1
1 2 3 4 1 2 3 4 1 2
0 0 1 0 0 0 1 0 0 0

1 1 1 1 1 1 1 1 1 1
1 2 3 4 1 2 3 4 1 2
0 0 1 0 0 0 1 0 0 0

1 1 1 1 1 1 1 1 1 1
1 2 3 4 1 2 3 4 1 2
0 0 1 0 0 0 1 0 0 0

0 0 0 0 0 0 0 0 0 0
1 2 1 2 1 2 1 2 1 2
1 0 0 0 1 0 0 0 1 0

0 0 0 0 0 0 0 0 0 0
1 2 1 2 1 2 1 2 1 2
1 0 0 0 1 0 0 0 1 0

0 0 0 0 0 0 0 0 0 0
1 2 1 2 1 2 1 2 1 2
1 0 0 0 1 0 0 0 1 0

0 0 0 0 0 0 0 0 0 0
1 2 1 2 1 2 1 2 1 2
1 0 0 0 1 0 0 0 1 0

0 0 0 0 0 0 0 0 0 0
1 2 1 2 1 2 1 2 1 2
1 0 0 0 1 0 0 0 1 0

0 0 0 0 0 0 0 0 0 0
1 2 1 2 1 2 1 2 1 2
1 0 0 0 1 0 0 0 1 0

0 0 0 0 0 0 0 0 0 0
1 2 1 2 1 2 1 2 1 2
1 0 0 0 1 0 0 0 1 0

1 1 1 1 1 1 1 1 1 1
1 2 3 4 1 2 3 4 1 2
0 0 1 0 0 0 1 0 0 0

1 1 1 1 1 1 1 1 1 1
1 2 3 4 1 2 3 4 1 2
0 0 1 0 0 0 1 0 0 0

1 1 1 1 1 1 1 1 1 1
1 2 3 4 1 2 3 4 1 2
0 0 1 0 0 0 1 0 0 0

1 1 1 1 1 1 1 1 1 1
1 2 3 4 1 2 3 4 1 2
0 0 1 0 0 0 1 0 0 0

1 1 1 1 1 1 1 1 1 1
1 2 3 4 1 2 3 4 1 2
0 0 1 0 0 0 1 0 0 0

1 1 1 1 1 1 1 1 1 1
1 2 3 4 1 2 3 4 1 2
0 0 1 0 0 0 1 0 0 0

1 1 1 1 1 1 1 1 1 1
1 2 3 4 1 2 3 4 1 2
0 0 1 0 0 0 1 0 0 0

1 1 1 1 1 1 1 1 1 1
1 2 3 4 1 2 3 4 1 2
0 0 1 0 0 0 1 0 0 0

1 1 1 1 1 1 1 1 1 1
1 2 3 4 1 2 3 4 1 2
0 0 1 0 0 0 1 0 0 0

1 1 1 1 1 1 1 1 1 1
1 2 3 4 1 2 3 4 1 2
0 0 1 0 0 0 1 0 0 0

1 1 1 1 1 1 1 1 1 1
1 2 3 4 1 2 3 4 1 2
0 0 1 0 0 0 1 0 0 0

1 1 1 1 1 1 1 1 1 1
1 2 3 4 1 2 3 4 1 2
0 0 1 0 0 0 1 0 0 0

1 1 1 1 1 1 1 1 1 1
1 2 3 4 1 2 3 4 1 2
0 0 1 0 0 0 1 0 0 0

1 1 1 1 1 1 1 1 1 1
1 2 3 4 1 2 3 4 1 2
0 0 1 0 0 0 1 0 0 0

1 1 1 1 1 1 1 1 1 1
1 2 3 4 1 2 3 4 1 2
0 0 1 0 0 0 1 0 0 0

1 1 1 1 1 1 1 1 1 1
1 2 3 4 1 2 3 4 1 2
0 0 1 0 0 0 1 0 0 0

0 0 0 0 0 0 0 0 0 0
1 2 1 2 1 2 1 2 1 2
1 0 0 0 1 0 0 0 1 0

0 0 0 0 0 0 0 0 0 0
1 2 1 2 1 2 1 2 1 2
1 0 0 0 1 0 0 0 1 0

0 0 0 0 0 0 0 0 0 0
1 2 1 2 1 2 1 2 1 2
1 0 0 0 1 0 0 0 1 0

0 0 0 0 0 0 0 0 0 0
1 2 1 2 1 2 1 2 1 2
1 0 0 0 1 0 0 0 1 0

0 0 0 0 0 0 0 0 0 0
1 2 1 2 1 2 1 2 1 2
1 0 0 0 1 0 0 0 1 0

0 0 0 0 0 0 0 0 0 0
1 2 1 2 1 2 1 2 1 2
1 0 0 0 1 0 0 0 1 0

0 0 0 0 0 0 0 0 0 0
1 2 1 2 1 2 1 2 1 2
1 0 0 0 1 0 0 0 1 0

0 0 0 0 0 0 0 0 0 0
1 2 1 2 1 2 1 2 1 2
1 0 0 0 1 0 0 0 1 0

0 0 0 0 0 0 0 0 0 0
1 2 1 2 1 2 1 2 1 2
1 0 0 0 1 0 0 0 1 0

0 0 0 0 0 0 0 0 0 0
1 2 1 2 1 2 1 2 1 2
1 0 0 0 1 0 0 0 1 0

