5

4
5
3
3
0

11

2 2 2 2 2
0 0 0 1 1
1 1 0 0 0
2 2 2 2 2

2 2 2 2 2
0 0 0 1 1
1 1 0 0 0
2 2 2 2 2

2 2 2 2 2
0 0 0 1 1
1 1 0 0 0
2 2 2 2 2

2 2 2 2 2
0 0 0 1 1
1 1 0 0 0
2 2 2 2 2

2 2 2 2 2
0 0 0 0 0
1 1 1 1 1
2 2 2 2 2

2 2 2 2 2
0 0 0 0 0
1 1 1 1 1
2 2 2 2 2

2 2 2 2 2
0 0 0 0 0
1 1 1 1 1
2 2 2 2 2

2 2 2 2 2
0 0 0 0 0
1 1 1 1 1
2 2 2 2 2

2 2 2 2 2
0 0 0 0 0
1 1 1 1 1
2 2 2 2 2

2 2 2 2 2
0 0 0 0 0
1 1 1 1 1
2 2 2 2 2

2 2 2 2 2
0 0 0 0 0
1 1 1 1 1
2 2 2 2 2

